R  800 600

S ./textures/olymp.xpm

EA                 ./textures/redbrick.xpm
NO ./textures/greystone.xpm
WE ./textures/blue.xpm
SO ./textures/eagle.xpm


F         50,255,50
C 50,90,100

11111111111111111111111111111
10000000001100000001111111111
10110000011100000000000010001
10120000000000000000000010001
10110000011100000000000010001
10000000001100000111011110001
11110111111111011100000010001
11110111111111011100010000001
11000000110101011000000000001
10002000000000000000000000001
10000000000000001101010010001
11000000110101011111011110001
111101111111022222222220000W1
11111111111111111111111111111